##############################
####.........###.............#
####.#.#####.....#########.#.#
#....#...#########.......#..##
..######.###...###.#.###.##.##
#...####.###.#...#.#...#....##
###.##...#...#.###.#.#########
###.#..#.#.###...#.###....####
#...#.##.#....##.#....#.#...##
#.##..#..#.##.##.####.#.###.##
#.######.##...#...#.#######.##
#......#.#.##.#.###..#.......#
######.##.....#...#.##.#####.#
#.#....##.#######.#....####..#
#...##.##.#.#.....##.#.....#.#
#.####....#.#.######.#####.###
#.#....##...#..##...#...##...#
#...##.#.#.###....#...#.####.H
###......#...##.###.###......#
##############################